1111111
1P0C011
1C00CE1
1111111