111111111
1000P00E1
1000C00E1
111111111