1111111111111111111
10C000111110C1E0011
1000000111000111011
1C00000010011110011
1000110000011110011
1P00110000000000011
1111111111111111111