111111111
1000P0001
1000C00E1
111111111