1111
1001
1C01
1P01
11E1
1111